1111111111111111
1K000000000010K1
1011100111100001
1010100100101101
1010110100101101
1010000000101101
101011G110111101
10101   10000001
10101   10111101
1010111110000001
1010000001101011
1010110100101001
1011100111101101
1K00000S000010K1
1111111111111111